11111111111111
1000000C0000C1
10101010010101
10101001010101
1P000C000C00E1
11111111111111