1111111111111
1P00001000001
1000001000001
10C00010X0001
10000E1000001
1111111111111
1000001000001
10X0001000001
1000001000001
1000001X00001
1111111111111