1111111111111
1C000C1C000C1
10000010000P1
1000001000001
1X0000C0000X1
11111C1C11111
1X0000C0000X1
1000001000001
1000001000CC1
1C000X1X00CE1
1111111111111