111111111
1CEP00001
111111111